████████████████████████████████████████████████
██      ██      ██  ██          ██      ██  ████
██████  ██  ██████  ██████  ██████  ██████  ████
██          ██  ██      ██      ██  ██      ████
██████  ██  ██  ██  ██████████  ██  ██████  ████
██      ██      ██  ██      ██  ██          ████
██████████  ██████  ██████  ██  ██████  ████████
██          ██      ██  ██  ██  ██          ████
██████████  ██  ██████  ██  ██  ██  ████████████
██  ██      ██      ██  ██          ██      ████
██  ██  ██  ██  ██████  ██  ██  ██████████  ████
██      ██                  ██      ██      ████
██  ██████  ██  ██  ██████  ██████████████  ████
██  ██      ██  ██      ██                  ████
██  ██████  ██████  ██████  ██  ██  ██████  ████
██      ██  ██  ██      ██  ██  ██      ██      
██  ██████████  ██  ██  ██████  ██  ████████████
██  ██  ██          ██  ██      ██  ██  ██  ████
██████  ██████  ██████  ██████  ██  ██  ██  ████
██              ██      ██      ██          ████
██  ██  ██  ██  ██████  ██████  ██████  ████████
██  ██  ██  ██      ██  ██      ██          ████
██████████  ████████████████████████████████████
██████████  ████████████████████████████████████